ஈடுபடவில்லையென்றும்	ஈ டு ப ட வி ல் லை யெ ன் று ம்
கேக்கறப்ப	கே க் க ற ப் ப
லட்சுமீகரம்	ல ட் சு மீ க ர ம்
கூறியவாறு	கூ றி ய வா று
மானத்தின்	மா ன த் தி ன்
பட்டினியை	ப ட் டி னி யை
உங்களுக்கும்	உ ங் க ளு க் கு ம்
ஜார்ஜைத்	ஜா ர் ஜை த்
கண்ணிரும்	க ண் ணி ரு ம்
தவளைக்குத்	த வ ளை க் கு த்
சித்ரான்ன	சி த் ரா ன் ன
எஸ்கிமோக்களின்	எ ஸ் கி மோ க் க ளி ன்
மரணத்தின்	ம ர ண த் தி ன்
எண்டெட்னு	எ ண் டெ ட் னு
மூங்கில்	மூ ங் கி ல்
செயல்பாடுகள்	செ ய ல் பா டு க ள்
சிலம்பில்	சி ல ம் பி ல்
அக்ரகாரம்	அ க் ர கா ர ம்
போயின்னா	போ யி ன் னா
அவமானப்படுத்திய	அ வ மா ன ப் ப டு த் தி ய
ஒளவையார்க்குக்	ஒ ள வை யா ர் க் கு க்
நாயை	நா யை
ஒப்பிடலாம்	ஒ ப் பி ட லா ம்
தென்றால்	தெ ன் றா ல்
போகபூமியைக்	போ க பூ மி யை க்
அம்மாளுக்கும்	அ ம் மா ளு க் கு ம்
கிறித்தவத்	கி றி த் த வ த்
நீருக்கு	நீ ரு க் கு
ஒற்றர்களாகவும்	ஒ ற் ற ர் க ளா க வு ம்
அணுவாக	அ ணு வா க
ஹெலோ	ஹெ லோ
எழுநூறு	எ ழு நூ று
பகையிலா	ப கை யி லா
உறவைச்	உ ற வை ச்
மதப்பற்று	ம த ப் ப ற் று
வெட்டிக்கொன்று	வெ ட் டி க் கொ ன் று
நெருக்கமான	நெ ரு க் க மா ன
ஆரம்பித்தவுடன்	ஆ ர ம் பி த் த வு ட ன்
ஓவியராக	ஓ வி ய ரா க
அவுட்	அ வு ட்
அர்ச்சித்திருக்கிறார்	அ ர் ச் சி த் தி ரு க் கி றா ர்
கவலைகளும்	க வ லை க ளு ம்
குட்டிச்சுவர்	கு ட் டி ச் சு வ ர்
ஹல்ஸ்	ஹ ல் ஸ்
கோட்டா	கோ ட் டா
உழைத்தாக	உ ழை த் தா க
தமிழச்சியின்	த மி ழ ச் சி யி ன்
இவர்களால்	இ வ ர் க ளா ல்
லேண்டுக்காகவும்	லே ண் டு க் கா க வு ம்
வந்திருப்பவர்	வ ந் தி ரு ப் ப வ ர்
ஸ்டியரிங்கை	ஸ் டி ய ரி ங் கை
பெளத்தம்	பெ ள த் த ம்
துணைப்பிரிவுடன்	து ணை ப் பி ரி வு ட ன்
கைகொடுத்து	கை கொ டு த் து
படர்கின்றன	ப ட ர் கி ன் ற ன
யான்பாதம்	யா ன் பா த ம்
சிவானந்தா	சி வா ன ந் தா
ஊடுதல்	ஊ டு த ல்
க்ஷணம்	க் ஷ ண ம்
நட்பைபெறுவதை	ந ட் பை பெ று வ தை
உங்களுள்	உ ங் க ளு ள்
பாட்டனைப்	பா ட் ட னை ப்
ஒதுக்கப்பட்ட	ஒ து க் க ப் ப ட் ட
திவா	தி வா
போய்விட்டன	போ ய் வி ட் ட ன
பதினொரு	ப தி னொ ரு
ஊழலி்ல்	ஊ ழ லி் ல்
விமர்சிக்கக்கூடியவரும்கூட	வி ம ர் சி க் க க் கூ டி ய வ ரு ம் கூ ட
சமாஜவாதியின்	ச மா ஜ வா தி யி ன்
ஹிஸ்ட்ரி	ஹி ஸ் ட் ரி
எண்ணியாங்கே	எ ண் ணி யா ங் கே
ஆஃப்பிராட்வே	ஆ ஃ ப் பி ரா ட் வே
மீட்டெடுக்கிறாள்	மீ ட் டெ டு க் கி றா ள்
மானத்தைத்	மா ன த் தை த்
இழப்பாய்	இ ழ ப் பா ய்
உண்டாகலாம்	உ ண் டா க லா ம்
ஆயிரத்துக்கும்	ஆ யி ர த் து க் கு ம்
நிர்ணயிக்கப்பட்டது	நி ர் ண யி க் க ப் ப ட் ட து
தூங்கிடுமோ	தூ ங் கி டு மோ
விசாரிக்கப்படவில்லை	வி சா ரி க் க ப் ப ட வி ல் லை
கூறிக்கொள்வோர்	கூ றி க் கொ ள் வோ ர்
முஷ்டாக்	மு ஷ் டா க்
ரன்களுடனும்	ர ன் க ளு ட னு ம்
நெஞ்சறி	நெ ஞ் ச றி
திறக்குமாம்	தி ற க் கு மா ம்
அயல்	அ ய ல்
பேரியோ	பே ரி யோ
ஆப்	ஆ ப்
ராயபுரம்	ரா ய பு ர ம்
சுலோகங்களில்	சு லோ க ங் க ளி ல்
ஊன்ற	ஊ ன் ற
ரதம்	ர த ம்
ரெஸ்ட்	ரெ ஸ் ட்
ஆண்டுகளும்	ஆ ண் டு க ளு ம்
சட்டத்தின்	ச ட் ட த் தி ன்
பேராசிரியர்களும்	பே ரா சி ரி ய ர் க ளு ம்
சண்டேவா	ச ண் டே வா
தண்டல்காரராய்க்	த ண் ட ல் கா ர ரா ய் க்
ஈடுபடவில்லை	ஈ டு ப ட வி ல் லை
துரிதப்படுத்தியதால்	து ரி த ப் ப டு த் தி ய தா ல்
